WL WL WL WL WL WL WL WL WL WL WL WL 
WL GL GL GL WL GL GL GL DB GL KS WL 
WL GL WL DS WL GL WL WL WL GL BS WL 
WL GL WL KB WL GL WL KB WL GL BS WL 
WL GL WL KB WL GL WL BL WL GL KS WL 
WL GL WL WL WL GL WL GL WL WL DB WL 
WL KS DB GL GL GL WL GL GL WL GL WL 
WL GL WL GL WL WL WL WL GL WL GL WL 
WL GL WL GL WL GL GL GL GL WL GL WL 
WL GL WL GL WL DG WL WL WL WL GL WL 
WL GL WL GL GL GL GL GL GL WL GL WL 
WL WL WL WL WL WL WL WL WL WL WL WL 
