WL WL WL WL WL WL WL WL WL WL WL WL 
WL GL GL GL GL GL GL GL GL GL GL WL 
WL GL WL WL WL GL WL WL WL GL GL WL 
WL GL WL WL WL GL WL GL WL GL GL WL 
WL GL WL WL WL GL WL GL WL GL GL WL 
WL GL WL WL WL GL WL GL WL WL GL WL 
WL GL GL GL GL GL WL GL GL WL GL WL 
WL GL WL GL WL WL WL WL GL WL GL WL 
WL GL WL GL WL GL GL GL GL WL GL WL 
WL GL WL GL WL GL WL WL WL WL GL WL 
WL GL GL GL GL GL GL GL GL GL GL WL 
WL WL WL WL WL WL WL WL WL WL WL WL 
